WWWWWWWWWW
W        0
Wg       W
WWWWW    W
W   W  B W
W   W  WWW
W   WB   W
W   WWW  W
W   h    W
WWWW1WWWWW
