WWWWWWWWWW
WW    g WW
W W h  W W
W   1    W
W   WW H W
W S WW S W
WH  S W  W
W W    W W
WW   f  WW
WWWW0WWWWW
