WWWWWWWWWW
1h   g   W
WWWWWWW  W
W s   S  W
W  WWWWWWW
W  f B   W
WWWWWWW  W
W  k     W
0    W f W
WWWWWWWWWW
