WWWWWWWWWW
W        W
W B  T   W
W  f     W
W    S   W
W   g    W
W  G     W
W      f W
W   h    W
WWWW1WWWWW
