WWWW0WWWWW
W        W
W  S     W
WWWWW    W
W   W    W
W   W  WWW
W        W
W   s    W
Wh       W
WWWWWWWWWW
