WWWWWWWWWW
W  f S g W
W WWWWWW W
W WW0WWW W
W W S  W W
W WWW  W W
W  g B W W
WWWWWWWW W
1h   S   W
WWWWWWWWWW
